1111111111111111
1000000000000001
1000000000000001
10C0000000000001
100000010001CCC1
1000000000000001
1111111111111101
1111111111111101
1000000000000001
1000000000000001
10C0000000000001
1000000100111111
1P000000000E0111
1111111111111111

