1111111111111111
100X00000000X001
1000XXXX00000001
1XC0000000000001
10000X010001CCC1
1000000000000001
1111111111111101
1111111111111101
1000000000000001
1000000000000001
10C000X0000000X1
1X00000100111111
1P000000000E0111
1111111111111111

